11111111111111
10000000000001
10000001000001
10000000000001
11111111111111