1111111111111111111111111111111111111111111111111111111111111111
1000000000000001100000000000000110000000000000011000000000000001
1000001100000001100000000000000110000000000000011000000000000001
1000000000000001100000000000000110000000000000011000000000000001
1000000000000001100000000000000110000000000000011000000000000001
1000000000000001100000000000000110000000000000011000000000000001
1000000000000001100000000000000110000000000000011000000000000001
1000000000000001100000000000000110000000000000011000000000000001
1000000000000001100000000000000110000000000000011000000000000001
10000E0C00P00001100000000000000110000000000000011000000000000001
1000000000000001100000000000000110000000000000011000000000000001
1000000000000001100000000000000110000000000000011000000000000001
1111111111111111100000000000000110000000000000011000000000000001
1111111111111111100000000000000110000000000000011000000000000001
1111111111111111100000000000000110000000000000011000000000000001
1111111111111111100000000000000110000000000000011000000000000001
1111111111111111100000000000000110000000000000011000000000000001
1111111111111111100000000000000110000000000000011000000000000001
1111111111111111100000000000000110000000000000011000000000000001
1111111111111111100000000000000110000000000000011000000000000001
1111111111111111100000000000000110000000000000011000000000000001
1111111111111111100000000000000110000000000000011000000000000001
1111111111111111100000000000000110000000000000011000000000000001
1111111111111111100000000000000110000000000000011000000000000001
1111111111111111100000000000000110000000000000011000000000000001
1111111111111111100000000000000110000000000000011000000000000001
1111111111111111100000000000000110000000000000011000000000000001
1111111111111111100000000000000110000000000000011000000000000001
1111111111111111100000000000000110000000000000011000000000000001
1111111111111111111111111111111111111111111111111111111111111111