11111111111111
10C00000000001
1000001110P001
100E00C0000001
11111111111111