1111111111111111
10C0000000000001
100P001100000001
100E00C000000001
1111111111111111