11111111111111
10C00000000001
100P0011000001
100E00C0000001
11111111111111