1111111111111111
1000000000000001
1000001100000001
1000000000000001
1000000000000001
1000000000000001
1000000000000001
1000000000000001
1000000000000001
10000E0C00P00001
1000000000000001
1000000000000001
1111111111111111