1111111111111111
10C0000000000001
100C001100000001
100E00C000000001
1000000000000001
1000000000000001
1000000000000001
1000000000000001
1000000000000001
10000000P0000001
1000000000000001
1000000000000001
1000000000000001
1111111111111111