1111111111111111
10C0000000000001
100C001100000001
100E00C0000P0001
1111111111111111