11111111111111
100C11100000E1
11011100111111
10001001100001
1C1000000P10C1
11111111111111