11111111111111
10P00000C00001
11111111110C01
10000000C00001
10C01111111111
1000000C000E01
11111111111111