11111111111111
100C1110000E00
11111111111111