11111111111111
10000P00000E01
11111111111111